# ONLY USE FOR REFERENCE!
888	# Invalid-TLD-Include
asus	# Invalid-TLD-StevenBlack-Porn
cim	# Invalid-TLD-StevenBlack-Porn
coma	# Invalid-TLD-RPIlist6
comde	# Invalid-TLD-StevenBlack-Porn
comj	# Invalid-TLD-StevenBlack-Porn
comm	# Invalid-TLD-RPIlist4
home	# Invalid-TLD-StevenBlack-Porn
mobil	# Invalid-TLD-StevenBlack-Porn
netchentai	# Invalid-TLD-RPIlist3
onion	# Invalid-TLD-RPIlist6
orgdojin	# Invalid-TLD-StevenBlack-Porn
pic	# Invalid-TLD-StevenBlack-Porn
por	# Invalid-TLD-RPIlist4
skinde	# Invalid-TLD-StevenBlack-Porn
som	# Invalid-TLD-StevenBlack-Porn
totolink	# Invalid-TLD-StevenBlack-Porn
tp	# Invalid-TLD-RPIlist6
x	# Invalid-TLD-Include
xx	# Invalid-TLD-StevenBlack-Porn
xy	# Invalid-TLD-StevenBlack-Porn
