# ONLY USE FOR REFERENCE!
asus	# Invalid-TLD-ADGH-Porn
bit	# Invalid-TLD-KidSaf
cim	# Invalid-TLD-ADGH-Porn
client	# Invalid-TLD-MyPDNS-Snuff
comde	# Invalid-TLD-ADGH-Porn
comj	# Invalid-TLD-Mhhakim
duoevents	# Invalid-TLD-MyPDNS-Snuff
experiments	# Invalid-TLD-MyPDNS-Snuff
home	# Invalid-TLD-ADGH-Porn
koko	# Invalid-TLD-KidSaf
lan	# Invalid-TLD-Mhhakim
loading	# Invalid-TLD-MyPDNS-Snuff
lusecurity	# Invalid-TLD-Mhhakim
maskeddefaultreferrerurl	# Invalid-TLD-MyPDNS-Snuff
mobil	# Invalid-TLD-ADGH-Porn
onion	# Invalid-TLD-KidSaf
onlysendduoevents	# Invalid-TLD-MyPDNS-Snuff
orgdojin	# Invalid-TLD-Mhhakim
overflow	# Invalid-TLD-MyPDNS-Snuff
pic	# Invalid-TLD-ADGH-Porn
skinde	# Invalid-TLD-ADGH-Porn
snowplowoptions	# Invalid-TLD-MyPDNS-Snuff
snowplowpseudonymizedpageurl	# Invalid-TLD-MyPDNS-Snuff
snowplowstandardcontext	# Invalid-TLD-MyPDNS-Snuff
som	# Invalid-TLD-ADGH-Porn
src	# Invalid-TLD-MyPDNS-Snuff
testid	# Invalid-TLD-MyPDNS-Snuff
totolink	# Invalid-TLD-ADGH-Porn
visibility	# Invalid-TLD-MyPDNS-Snuff
xx	# Invalid-TLD-Mhhakim
xy	# Invalid-TLD-ADGH-Porn
